71
81
9 54 62 21 81 62 75 81 99 33 98 18 2 43 47 45 77 7 96 62 87 25 88 57 44 11 29 73 88 6 79 30 1 88 36 87 28 87 69 59 32 36 24 55 20 87 85 95 76 89 97 19 23 8 35 53 23 65 49 30 30 40 86 70 67 36 29 89 39 16 82 51 41 75 43 90 35 74 66 64 86 
16 83 13 84 64 75 11 56 31 37 51 79 90 32 28 70 79 8 76 11 56 47 56 21 61 46 21 79 92 0 28 5 96 15 31 47 92 86 88 63 90 67 18 0 98 99 0 29 90 78 47 59 92 42 45 90 43 98 41 16 39 50 66 79 79 78 33 11 38 86 64 74 1 60 62 9 8 53 19 98 35 
71 78 64 3 23 39 44 78 61 52 76 42 41 92 53 41 18 53 7 47 97 30 27 69 34 78 58 96 27 87 5 12 20 71 59 56 98 97 32 69 20 72 78 83 34 93 95 74 18 59 81 79 89 70 93 0 35 33 85 53 71 81 35 81 58 29 47 56 58 38 21 11 55 84 61 41 95 12 13 53 53 
65 16 74 31 64 31 56 8 54 47 34 60 8 63 60 59 37 3 51 35 78 82 47 40 24 37 93 16 27 98 23 63 95 82 80 4 74 83 11 28 30 54 57 10 46 34 10 48 68 28 22 75 9 8 33 68 77 98 72 68 9 38 96 71 57 38 47 92 17 61 63 61 76 23 89 64 62 47 41 41 39 
51 90 76 70 97 11 72 24 50 92 89 80 32 13 81 62 97 88 98 72 58 98 9 61 79 7 88 39 37 38 0 52 89 94 6 99 59 71 12 71 79 55 25 35 84 7 9 36 74 21 14 68 75 84 45 68 48 59 62 88 1 99 41 77 86 2 66 81 81 85 85 30 69 36 55 9 95 28 23 31 52 
30 30 22 17 52 47 30 63 91 7 81 19 49 84 45 58 55 28 28 58 41 99 92 95 79 97 13 2 30 76 64 59 83 56 61 57 33 64 13 15 1 62 47 20 54 93 75 58 4 87 74 81 81 63 30 21 36 49 51 5 30 8 61 5 99 9 81 22 43 98 53 1 60 64 19 56 94 49 20 44 4 
54 13 60 53 32 44 21 80 40 86 65 8 89 57 11 49 22 59 29 83 62 89 58 94 34 97 47 30 47 39 69 33 14 60 46 65 16 52 20 8 82 17 72 90 2 79 25 69 93 98 72 58 84 49 85 21 22 83 76 40 10 18 95 6 56 3 83 94 50 92 26 70 24 71 14 75 18 86 35 35 75 
77 84 41 87 26 64 62 22 98 10 35 66 72 49 4 7 55 62 98 54 92 73 25 85 64 89 89 83 30 37 49 80 57 33 15 35 68 49 19 22 53 86 37 5 37 48 52 22 21 46 39 92 62 25 69 5 41 77 74 7 95 84 94 63 28 96 82 5 87 12 32 32 65 7 71 12 83 80 7 14 45 
75 77 71 11 74 76 54 68 84 73 78 39 33 2 2 98 89 79 87 26 75 42 73 36 22 39 24 91 3 31 65 66 89 30 9 30 9 4 45 30 53 50 71 31 46 37 94 34 8 74 17 97 57 5 28 99 47 56 20 7 48 78 58 23 59 92 20 44 25 42 47 81 86 20 64 31 86 2 8 82 42 
6 97 16 28 30 97 88 13 11 82 9 75 24 16 85 21 41 16 99 1 22 22 7 67 75 84 92 81 79 80 9 35 61 80 47 50 74 19 60 40 36 13 29 45 3 95 61 28 54 87 59 51 71 32 18 78 62 20 46 60 1 91 26 88 90 68 31 25 85 88 40 17 55 2 33 54 84 63 78 22 84 
85 83 15 35 41 76 61 99 76 83 19 91 10 76 63 84 39 32 78 52 39 31 14 17 55 97 78 98 66 16 48 51 77 20 60 4 81 74 72 16 28 53 73 48 48 27 38 66 17 40 63 64 89 22 94 19 3 6 14 50 8 45 7 41 27 81 56 55 26 56 13 47 15 99 64 5 2 72 19 0 98 
42 86 96 19 1 21 59 46 29 79 57 72 69 33 23 66 86 14 62 30 49 20 48 76 8 95 63 67 16 81 17 94 62 96 34 66 71 85 32 50 0 0 11 17 13 34 64 57 41 78 37 39 36 4 42 44 67 81 16 2 68 3 81 48 45 73 96 42 17 95 16 49 67 32 67 78 58 64 78 19 83 
81 45 41 68 88 39 49 10 96 76 32 71 3 58 79 32 15 11 23 65 23 13 20 42 62 87 16 24 38 31 45 83 0 71 33 34 72 58 71 43 63 83 65 86 30 58 35 36 14 90 36 85 52 81 29 48 32 29 18 46 12 57 89 98 65 63 76 40 2 54 96 74 78 3 50 48 91 99 58 71 0 
55 82 41 35 64 97 66 11 67 81 87 29 71 20 57 12 93 68 79 0 71 18 38 85 49 22 18 69 79 46 80 84 56 44 23 98 11 93 96 10 51 22 46 93 88 22 12 37 37 90 14 72 45 84 68 43 2 24 67 1 91 46 42 25 7 12 91 99 66 59 36 82 48 1 7 51 54 41 46 76 71 
16 15 62 30 17 1 7 59 84 79 90 56 75 16 16 82 4 76 70 17 54 80 12 53 35 69 10 76 47 23 72 95 14 54 35 26 81 79 80 66 40 39 10 82 83 72 8 81 80 42 13 47 5 63 82 9 14 60 36 30 24 24 91 13 90 71 85 4 48 88 16 54 77 34 24 7 67 79 82 14 9 
18 55 95 20 35 92 21 59 53 18 84 91 95 3 79 30 4 81 29 66 24 9 18 19 79 48 54 93 89 58 25 82 39 6 44 41 23 75 19 98 61 80 68 22 44 73 72 37 12 53 10 50 48 13 10 95 45 94 90 57 9 65 16 35 38 43 64 4 4 84 55 80 27 95 31 61 90 28 14 17 34 
44 38 28 45 98 40 79 17 38 61 6 80 34 56 46 84 80 56 91 1 42 96 47 99 53 80 61 58 85 86 76 99 65 19 49 93 34 19 56 20 65 58 4 58 50 60 24 2 66 81 85 38 54 95 14 28 41 21 88 73 14 8 63 6 15 94 38 34 18 24 41 13 63 21 44 96 16 91 92 13 12 
76 67 75 28 51 72 34 5 17 1 44 98 50 0 41 47 27 47 85 7 23 91 40 4 48 44 92 61 43 53 49 59 12 19 43 10 53 90 93 40 41 10 22 43 0 32 19 97 91 21 22 74 67 74 37 50 39 73 0 77 3 61 3 80 12 69 81 77 54 29 94 47 28 56 30 70 66 36 13 88 28 
92 2 26 5 99 45 83 57 10 10 57 61 30 8 89 27 99 54 41 65 92 87 5 5 73 46 33 51 97 69 57 76 90 68 77 40 74 84 79 33 96 57 95 95 82 34 57 11 28 85 8 53 23 57 60 40 63 65 3 45 19 37 12 12 68 48 86 67 90 51 4 12 46 18 9 47 36 83 51 59 31 
7 49 55 71 33 55 61 27 2 61 20 31 64 18 64 41 55 79 98 1 67 3 78 54 13 73 32 68 62 78 89 75 85 93 53 61 86 95 1 21 38 25 89 21 32 77 38 88 98 79 89 33 31 54 6 80 59 75 57 22 32 37 11 19 36 98 88 7 33 68 67 22 64 53 77 49 58 2 91 7 96 
68 72 33 37 5 40 25 98 65 49 45 40 87 96 48 37 38 70 60 2 66 19 27 13 7 32 12 44 92 29 49 5 4 64 49 16 25 49 70 90 1 65 35 36 10 33 39 2 39 96 5 59 38 74 79 59 83 34 92 18 79 8 96 54 31 49 82 64 21 70 19 3 66 26 45 37 12 40 46 91 53 
42 64 16 77 57 97 50 27 90 37 68 2 11 96 11 49 0 14 86 56 56 95 99 21 57 13 10 60 9 87 18 98 71 83 20 65 50 33 85 8 39 35 92 68 23 47 20 27 94 52 7 44 47 60 97 83 75 32 83 90 19 88 3 92 95 17 16 43 60 63 37 51 57 47 25 60 10 68 9 98 77 
99 25 11 23 75 98 3 97 47 91 53 38 51 19 31 37 58 97 85 62 63 72 85 67 8 76 57 97 30 44 81 39 83 48 5 39 5 76 64 3 38 56 0 91 28 91 78 47 97 72 92 77 17 67 89 73 8 89 14 54 35 39 69 25 90 29 19 19 44 4 71 53 57 83 62 64 20 23 34 60 57 
97 98 66 7 85 56 2 52 99 94 93 35 10 74 45 20 94 79 6 15 61 0 11 68 14 76 50 62 23 2 70 76 89 0 81 99 38 21 35 53 72 67 38 77 99 7 51 29 69 15 44 77 99 7 24 66 13 82 30 71 15 52 60 84 56 5 4 84 56 49 11 45 13 94 48 10 32 46 58 78 17 
92 17 90 73 31 14 24 58 61 9 44 35 5 89 2 73 63 66 57 31 79 12 42 85 28 64 59 51 8 36 6 5 71 16 47 8 81 82 47 57 53 26 68 49 56 72 17 22 35 45 90 36 61 9 71 36 28 10 40 81 5 64 68 83 39 62 26 20 25 40 14 80 73 51 44 2 31 68 90 69 66 
54 61 26 75 77 15 52 67 62 25 63 55 14 88 43 15 14 64 93 45 94 30 36 22 76 53 19 37 98 17 82 32 93 6 53 14 74 21 93 26 13 70 7 38 69 70 87 31 41 88 54 0 83 68 81 84 1 51 70 87 15 3 47 44 87 29 3 84 18 66 63 71 3 99 6 71 28 28 0 14 65 
57 15 38 79 60 88 55 46 25 62 39 84 15 60 94 68 0 25 36 53 76 24 82 16 64 27 55 4 22 36 87 46 45 9 0 74 25 89 27 90 88 68 89 49 28 4 52 28 6 92 41 4 27 66 80 73 74 28 85 88 44 66 98 97 12 25 58 54 22 57 7 38 15 95 59 29 95 37 9 50 39 
76 40 67 21 88 10 0 38 63 69 30 17 56 45 69 31 87 99 33 43 62 81 16 93 62 87 53 1 44 63 62 87 80 57 93 25 31 33 33 52 27 39 90 15 66 0 94 12 54 59 74 61 51 57 13 1 80 92 53 55 62 0 58 62 15 26 49 22 98 32 73 24 1 99 14 97 25 89 70 14 38 
99 20 65 70 52 75 92 54 15 6 78 38 54 75 28 46 90 89 39 79 0 62 54 96 39 24 89 64 88 1 10 87 83 29 47 52 30 96 10 28 15 83 71 91 8 59 10 25 98 67 89 43 28 96 15 8 78 52 73 67 81 11 8 25 75 73 35 27 64 90 69 50 26 6 67 94 41 3 46 46 15 
78 59 79 53 64 18 11 58 14 52 60 86 65 23 83 35 91 68 81 91 46 81 56 43 86 74 31 96 84 77 51 10 52 88 18 11 65 99 78 89 42 26 96 26 98 65 81 7 56 47 60 14 25 62 31 46 90 13 6 35 16 21 85 19 43 87 69 19 50 27 82 68 83 52 30 64 88 57 39 16 62 
79 55 98 49 91 15 68 22 35 65 46 34 1 23 98 28 46 28 2 67 91 79 29 71 43 59 52 23 14 95 73 99 45 71 62 31 90 58 57 4 55 22 83 7 31 27 75 16 97 93 15 7 86 53 6 65 13 18 8 54 72 47 75 23 13 87 75 40 59 13 18 43 14 14 91 63 11 24 15 62 18 
68 43 98 37 96 56 10 96 76 78 7 12 75 66 48 34 3 23 19 10 10 36 66 6 63 8 49 27 69 39 44 20 37 99 39 78 15 91 7 46 38 4 25 98 61 31 94 25 81 94 61 1 72 93 73 27 95 94 96 73 18 90 27 49 69 40 6 53 27 48 85 52 54 89 68 19 68 71 50 6 31 
38 95 28 78 46 14 14 53 63 88 71 28 34 47 17 15 14 25 4 67 4 52 38 6 7 45 94 81 4 34 94 45 33 75 89 69 42 11 59 47 41 17 74 49 42 10 45 48 7 26 67 69 88 34 18 65 1 17 1 94 45 34 3 65 99 5 1 79 28 43 62 62 77 16 25 4 42 56 57 13 11 
1 9 19 79 6 97 35 77 19 87 65 23 55 17 10 87 64 17 58 16 10 89 63 76 0 56 87 44 53 83 63 84 31 47 31 71 61 24 40 86 20 34 68 23 97 54 76 46 73 10 78 71 48 65 40 56 67 70 27 79 42 57 46 36 18 28 44 5 37 4 37 75 86 41 32 69 85 8 21 15 72 
28 69 90 66 80 30 43 86 66 69 95 59 36 87 65 9 23 46 31 55 52 59 85 17 25 88 78 91 43 13 79 3 61 76 77 97 98 54 33 11 49 21 0 24 10 57 24 70 44 75 32 1 86 47 44 51 54 56 93 52 58 42 41 16 25 49 47 64 24 63 91 24 52 0 74 17 8 26 30 69 89 
27 54 94 56 82 46 87 33 91 28 92 31 21 21 59 47 86 49 78 67 4 66 44 63 19 40 81 74 39 66 51 48 2 4 12 86 66 37 0 66 69 98 91 1 4 64 61 97 59 47 27 5 83 18 1 49 20 8 46 13 99 38 34 35 14 69 15 97 76 88 46 28 78 6 7 96 79 1 36 89 38 
74 41 97 15 87 79 78 59 16 94 95 60 6 19 98 81 70 27 23 47 37 30 74 83 20 26 60 88 67 76 92 44 1 46 3 30 14 20 85 60 56 87 20 54 56 89 8 19 40 36 14 80 34 33 56 27 66 60 89 67 78 16 2 9 81 52 32 99 37 76 67 34 3 2 15 14 65 35 1 67 80 
49 39 27 28 99 34 54 27 90 98 28 84 65 54 53 5 98 52 27 82 16 24 51 44 12 28 63 66 8 24 94 61 4 70 65 73 18 16 61 33 44 95 81 49 20 82 50 2 9 72 24 42 92 26 6 95 11 76 60 24 11 39 44 41 69 21 69 56 6 71 8 35 80 70 16 18 33 89 63 83 4 
35 29 63 2 5 89 97 53 15 45 22 86 54 39 6 58 1 42 33 31 79 83 16 45 80 23 65 67 61 33 93 10 61 86 84 24 36 43 14 86 72 81 84 53 28 35 17 85 41 8 12 80 49 94 36 19 23 13 23 68 53 43 98 99 45 57 38 72 92 64 72 44 55 81 19 43 55 64 18 15 65 
96 93 60 76 79 68 16 81 54 0 74 97 85 96 86 27 52 97 1 48 69 11 56 64 42 0 8 47 81 27 11 40 35 1 8 56 17 10 56 30 64 5 22 42 34 18 43 0 13 8 85 38 13 95 54 84 94 31 0 70 2 8 27 94 9 85 92 56 98 44 58 17 19 59 35 17 95 18 15 5 80 
8 48 34 58 54 50 62 16 92 30 44 90 23 76 84 0 35 30 82 46 79 36 13 22 31 39 20 56 45 30 93 5 55 65 92 30 1 61 45 21 93 92 1 42 62 7 52 1 3 49 41 82 64 62 85 54 15 1 96 38 62 81 34 37 21 69 99 61 72 93 85 71 67 37 10 31 34 81 11 75 33 
11 72 44 93 62 63 77 17 78 47 1 0 60 79 15 11 51 32 29 63 80 38 80 97 46 55 53 50 15 97 0 27 11 33 95 99 58 57 12 64 57 82 58 18 97 24 46 9 77 64 24 95 1 46 76 54 35 75 5 84 55 31 31 53 21 5 49 66 12 76 49 36 11 34 44 17 92 31 80 0 30 
25 75 71 14 57 82 99 0 56 49 23 65 59 57 30 30 43 96 42 86 0 71 59 60 79 50 21 1 22 24 56 21 53 29 4 19 77 56 55 20 22 3 73 54 60 97 97 69 59 17 31 88 84 12 5 69 67 2 68 88 89 31 6 90 35 7 5 48 48 33 29 83 66 96 89 31 39 38 22 2 18 
52 62 87 80 83 63 42 52 43 54 4 41 18 8 13 82 4 94 9 63 18 7 58 34 6 30 58 44 39 4 1 16 52 47 40 76 92 66 86 27 57 40 56 33 94 96 83 23 54 23 43 97 37 43 17 94 93 66 92 28 76 73 18 59 36 9 82 75 81 48 46 35 78 66 72 87 87 81 49 74 7 
24 31 42 40 0 87 88 64 17 82 34 10 22 10 99 41 13 84 31 0 95 76 54 59 6 35 31 35 90 37 61 36 28 45 81 43 22 35 98 53 94 19 0 82 9 67 72 90 9 14 14 93 62 34 99 16 2 67 20 48 34 20 46 77 48 23 4 25 28 29 28 37 69 85 23 29 77 51 71 19 69 
67 11 97 22 20 66 62 62 24 50 69 1 54 36 4 29 31 21 20 50 85 53 44 96 23 77 14 48 52 45 80 73 25 1 26 79 33 19 37 25 67 84 94 28 56 60 14 7 55 10 67 58 21 75 66 49 88 71 86 94 96 81 51 85 44 18 97 24 3 40 94 81 16 41 88 47 2 50 29 20 5 
64 9 73 10 71 18 25 70 15 91 81 43 89 95 37 14 17 65 89 36 46 52 50 71 1 51 46 0 77 0 39 94 28 31 2 54 11 31 36 3 52 31 73 27 30 24 42 49 39 42 42 19 4 93 58 19 99 81 15 50 53 84 70 73 79 4 14 96 26 36 53 81 40 76 28 36 97 15 54 88 46 
14 74 22 1 29 19 58 50 85 94 72 2 32 37 20 64 64 73 89 80 44 97 19 44 63 61 93 8 12 47 26 34 94 32 99 78 9 31 52 15 26 15 91 52 60 34 8 58 81 61 92 76 85 80 40 50 99 73 78 73 49 79 85 82 33 26 30 19 10 55 98 45 56 63 35 38 34 87 33 25 1 
92 88 41 46 72 12 34 60 3 73 40 63 71 64 22 11 13 29 83 24 90 96 49 70 9 42 20 74 47 96 31 11 23 74 14 10 38 10 9 56 0 48 89 16 88 73 11 82 79 69 25 31 32 67 52 2 73 40 93 17 12 66 30 13 11 23 53 20 32 7 38 84 91 11 75 25 79 74 50 43 33 
46 92 67 43 66 71 35 51 41 35 53 87 91 10 91 26 74 69 81 5 30 74 21 7 89 27 2 83 51 33 68 3 42 55 13 72 66 1 85 38 84 31 76 51 17 31 13 60 6 21 87 82 26 85 88 57 1 35 47 98 71 5 76 4 0 98 77 53 52 14 37 34 6 96 38 63 54 91 41 52 60 
60 43 25 91 44 27 98 51 91 45 18 15 52 48 3 13 19 62 22 8 70 13 11 57 66 42 32 16 34 44 69 13 51 48 68 75 22 2 31 59 86 63 37 69 57 99 81 70 19 25 39 80 21 75 91 61 21 6 75 40 91 54 95 54 1 0 95 47 93 1 92 59 54 58 83 98 81 90 78 98 3 
38 10 7 50 77 29 14 40 84 60 56 98 38 18 7 45 83 47 94 33 10 97 17 48 52 85 3 63 62 87 94 98 30 41 58 28 48 54 33 86 46 14 71 97 28 56 28 28 20 86 0 51 80 15 51 21 14 36 83 95 29 95 37 71 76 87 49 64 58 60 71 39 24 24 53 48 51 8 44 23 19 
27 16 55 46 19 16 72 14 3 72 87 27 77 52 60 4 28 82 84 45 19 89 7 65 2 7 27 87 28 46 25 56 88 27 9 22 97 36 56 12 27 79 17 48 28 73 19 26 57 59 25 29 45 79 76 74 16 73 54 83 50 11 9 76 55 84 42 26 39 19 43 18 25 64 73 88 94 40 70 50 95 
91 7 43 79 34 17 70 7 30 72 20 63 12 4 91 79 67 3 64 65 19 43 83 72 41 91 79 29 90 32 47 67 97 53 50 32 4 25 95 90 38 22 82 76 31 19 10 16 53 4 0 37 94 28 85 78 65 99 53 80 4 74 39 92 52 33 8 48 80 52 77 4 57 83 88 29 80 66 51 97 96 
86 88 3 86 44 68 4 12 62 38 97 22 54 45 57 96 79 13 40 16 90 4 8 65 75 54 67 75 94 4 81 10 24 26 20 20 71 43 74 76 89 54 5 3 4 99 99 63 69 95 80 77 54 12 48 58 84 51 18 24 32 71 59 42 15 41 94 71 25 85 63 82 53 47 93 58 6 94 80 34 73 
84 22 40 49 27 78 99 52 11 65 63 17 86 24 93 39 6 7 58 51 62 6 57 79 43 8 95 28 4 89 6 8 46 14 8 13 86 22 33 76 71 95 35 0 71 72 75 16 90 90 67 87 30 66 59 34 12 87 54 12 58 11 24 19 24 68 92 0 47 66 76 30 19 78 17 98 69 35 76 5 30 
36 42 92 16 24 7 55 8 5 69 47 76 14 5 71 15 58 68 69 98 47 68 19 69 76 9 16 92 68 34 69 67 57 5 69 56 13 83 12 36 29 43 74 64 0 44 17 28 4 42 41 33 34 60 46 6 73 50 60 85 73 51 24 43 47 30 23 44 88 21 79 93 45 15 98 71 18 47 9 64 83 
8 58 26 11 91 52 6 19 84 24 74 87 7 33 27 54 81 34 80 12 82 54 60 93 54 85 67 17 95 90 20 44 45 24 39 12 90 86 77 18 6 67 82 9 36 57 5 24 58 77 46 94 13 99 78 75 11 59 26 32 91 24 8 54 74 8 49 29 60 10 76 20 32 55 2 28 50 9 57 57 9 
12 55 89 34 46 29 46 98 29 2 31 49 47 79 93 52 37 82 75 67 55 20 6 78 71 24 92 63 43 39 91 37 91 21 47 30 11 74 23 71 31 61 65 34 42 66 35 44 6 74 28 71 97 82 78 48 62 57 62 4 22 40 89 32 4 51 11 20 36 59 34 34 65 93 28 47 52 58 15 41 92 
89 28 37 8 15 85 70 14 82 88 48 62 93 95 65 79 84 56 95 48 51 91 59 90 23 55 7 97 76 6 32 91 13 73 44 68 42 92 53 54 99 41 50 40 74 54 4 75 92 34 1 52 10 9 47 84 19 59 29 77 33 59 34 60 74 62 21 50 35 76 13 33 75 97 94 54 92 55 46 71 75 
24 67 32 49 22 48 72 34 18 27 76 49 65 82 41 32 19 70 23 94 95 40 43 15 17 24 66 1 42 52 63 17 89 33 22 63 10 53 52 83 25 72 63 90 10 55 53 31 1 42 74 59 24 24 49 31 92 74 17 93 79 16 25 67 42 25 35 99 4 49 75 80 91 96 14 67 41 8 90 27 91 
84 3 23 59 65 92 31 30 50 79 45 31 19 47 36 67 74 32 40 61 92 82 1 37 72 70 87 28 60 94 6 47 58 93 67 78 78 43 36 55 54 53 94 28 33 17 55 72 56 71 43 15 98 27 64 69 97 74 9 59 2 95 12 14 77 90 32 87 64 67 39 31 84 96 56 17 23 53 4 24 62 
3 9 6 58 34 5 63 3 68 36 57 53 61 30 31 40 56 81 19 90 60 33 81 8 1 19 76 50 87 90 46 92 59 16 27 80 55 79 33 29 2 81 36 86 99 66 69 20 11 57 17 51 59 25 89 18 71 55 89 5 57 93 97 59 60 34 14 67 28 31 15 71 97 0 30 64 18 63 49 87 71 
22 16 62 28 68 16 76 66 46 59 17 29 92 63 23 48 4 24 36 86 62 15 80 77 84 30 17 54 3 99 26 54 8 78 33 72 21 23 60 75 60 62 41 13 78 14 21 89 32 12 8 24 35 9 89 78 53 31 26 12 53 49 2 19 57 17 18 68 69 46 10 91 86 18 14 39 23 47 43 71 62 
80 36 20 57 31 51 29 5 36 56 89 8 41 32 1 52 81 41 50 78 5 36 13 14 69 43 41 70 57 90 54 83 47 89 54 86 16 40 68 55 50 43 82 31 45 79 66 31 71 51 94 49 44 33 70 46 8 70 78 39 52 57 66 64 44 83 45 55 64 80 0 50 92 18 1 37 98 84 61 88 7 
29 49 29 77 60 81 57 87 18 67 29 25 14 85 77 71 15 97 58 6 72 93 22 87 32 79 73 49 29 78 96 82 60 47 56 40 92 3 8 21 32 67 23 15 72 49 7 82 36 6 33 76 70 79 6 18 81 51 46 93 82 25 60 43 43 74 28 6 33 27 70 20 58 9 92 9 3 38 56 84 11 
0 18 32 51 21 19 87 74 76 90 32 26 49 83 30 93 16 73 83 32 5 96 91 17 27 97 54 52 30 8 15 28 70 47 54 15 72 25 24 10 3 78 73 31 35 71 69 80 29 34 30 70 74 3 58 92 86 0 72 85 58 18 14 58 35 86 21 79 40 4 68 99 22 92 22 12 32 80 35 53 9 
60 53 70 88 28 29 75 78 47 44 2 12 68 89 51 4 12 38 37 96 4 96 12 17 80 2 47 58 40 90 61 16 12 35 67 84 24 82 19 69 55 79 91 28 31 52 12 21 83 48 35 24 26 57 45 10 9 95 58 44 11 84 84 83 85 39 96 79 8 21 71 45 23 49 15 89 84 30 24 42 29 
36 43 1 14 3 98 22 38 60 6 55 2 42 59 32 24 80 9 75 27 29 55 86 46 8 81 56 91 59 79 44 95 5 59 19 64 67 90 20 31 10 48 0 82 51 47 89 53 88 76 74 80 30 15 63 31 65 21 57 55 7 75 41 3 3 7 30 7 77 65 19 77 81 13 8 12 28 91 98 62 14 
6 48 58 86 35 2 11 38 77 54 61 58 15 34 53 33 76 0 7 68 11 27 12 2 77 14 54 2 57 70 31 78 20 87 53 70 94 35 92 39 78 10 3 92 18 21 87 69 66 68 49 14 18 14 0 80 27 29 95 65 22 98 3 31 19 39 19 55 1 8 31 14 67 93 24 30 75 69 82 55 70 
49 57 20 29 39 12 17 20 63 89 31 0 14 88 17 72 92 65 59 56 91 16 49 85 50 33 53 8 38 93 41 51 61 68 91 3 62 37 22 27 84 0 2 74 75 34 78 83 57 89 8 94 22 7 68 53 27 66 42 8 8 0 40 75 66 44 65 83 46 28 48 72 20 98 46 52 10 23 3 66 23 
